
top|server|response

---------------------------------------------------------------------------------------------
com|whois.crsnic.net|No match for|whois.networksolutions.com|whois.internic.net|Whois Server: 
net|whois.crsnic.net|No match for|whois.networksolutions.com|whois.internic.net|Whois Server: 
org|whois.publicinterestregistry.net|NOT FOUND|whois.publicinterestregistry.net|whois.publicinterestregistry.net|Whois Server: 
co.uk|whois.nic.uk|No match|whois.nic.uk|whois.nic.uk|
edu|whois.internic.net|No match|whois.networksolutions.com|whois.internic.net|
mil|whois.internic.net|No match|whois.networksolutions.com|whois.internic.net|
ac|whois.nic.ac|No match for|whois.nic.ac|whois.nic.ac|
af|whois.netnames.net|No Match|whois.netnames.net|whois.netnames.net|
am|whois.nic.am|No information available|whois.nic.am|whois.nic.am|
as|whois.nic.as|Domain Not Found|whois.nic.as|whois.nic.as|
at|whois.nic.at|nothing found|whois.nic.at|whois.nic.at|
be|whois.dns.be|No such domain|whois.dns.be|whois.dns.be|
br|whois.nic.br|No match for|whois.nic.br|whois.nic.br|
ca|whois.cira.ca|AVAIL|whois.cira.ca|whois.cira.ca|
cc|whois.nic.cc|No match|whois.nic.cc|whois.nic.cc|
cx|whois.nic.cx|No match for|whois.nic.cx|whois.nic.cx|
cz|whois.nic.cz|No data found|whois.nic.cz|whois.nic.cz|
de|whois.nic.de|No entries found|whois.nic.de|whois.nic.de|
dk|whois.dk-hostmaster.dk|No entries found|whois.dk-hostmaster.dk|whois.dk-hostmaster.dk|
fo|whois.ripe.net|No entries found|whois.ripe.net|whois.ripe.net|
fr|whois.nic.fr|No entries found|whois.nic.fr|whois.nic.fr|
gf|whois.nplus.gf|not found in our database|whois.nplus.gf|whois.nplus.gf|
gs|whois.adamsnames.tc|is not registered|whois.adamsnames.tc|whois.adamsnames.tc|
is|whois.isnic.is|No entries found|whois.isnic.is|whois.isnic.is|
it|whois.nic.it|No entries found|whois.nic.it|whois.nic.it|
co.jp|whois.nic.ad.jp|No match|whois.nic.ad.jp|whois.nic.ad.jp|
li|whois.nic.li|No match for|whois.nic.li|whois.nic.li|
lt|whois.ripe.net|No entries found|whois.ripe.net|whois.ripe.net|
lu|whois.dns.lu|No entries found|whois.dns.lu|whois.dns.lu|
ms|whois.adamsnames.tc|is not registered|whois.adamsnames.tc|whois.adamsnames.tc|
mx|whois.nic.mx|Referencias de Organization No Encontradas|whois.nic.mx|whois.nic.mx|
nl|whois.domain-registry.nl|not a registered domain|whois.domain-registry.nl|whois.domain-registry.nl|
no|whois.norid.no|no matches|whois.norid.no|whois.norid.no|
nu|whois.nic.nu|NO MATCH for|whois.nic.nu|whois.nic.nu|
pl|whois.dns.pl|does not exists|whois.dns.pl|whois.dns.pl|
pt|whois.ripe.net|No entries found|whois.ripe.net|whois.ripe.net|
ru|whois.ripn.net|No entries found|whois.ripn.net|whois.ripn.net|
se|whois.nic-se.se|No data found|whois.nic-se.se|whois.nic-se.se|
si|whois.arnes.si|No entries found|whois.arnes.si|whois.arnes.si|
sk|whois.ripe.net|No entries found|whois.ripe.net|whois.ripe.net|
st|whois.nic.st|No entries found|whois.nic.st|whois.nic.st|
tc|whois.adamsnames.tc|is not registered|whois.adamsnames.tc|whois.adamsnames.tc|
tf|whois.adamsnames.tc|is not registered|whois.adamsnames.tc|whois.adamsnames.tc|
tj|whois.nic.tj|No match|whois.nic.tj|whois.nic.tj|
tm|whois.nic.tm|No match|whois.nic.tm|whois.nic.tm|
to|monarch.tonic.to|No match for|monarch.tonic.to|monarch.tonic.to|
com.tw|whois.twnic.net|No Records Found|whois.twnic.net|whois.twnic.net|
vg|whois.adamsnames.tc|is not registered|whois.adamsnames.tc|whois.adamsnames.tc|
sh|whois.nic.sh|No match|whois.nic.sh|whois.nic.sh|
kz|whois.domain.kz|No entries found|whois.domain.kz|whois.domain.kz|
ch|whois.nic.ch|not have an entry|whois.nic.ch|whois.nic.ch|
info|whois.afilias.net|NOT FOUND|whois.afilias.net|whois.afilias.net|
ua|whois.net.ua|% No entries found|whois.net.ua|whois.net.ua|
biz|whois.nic.biz|Not found|whois.nic.biz|whois.nic.biz|
ws|whois.nic.ws|No match for|whois.nic.ws|whois.nic.ws|
gov|whois.nic.gov|No match for|whois.nic.gov|whois.nic.gov|
tv|whois.internic.net|No match for|whois.internic.net|whois.internic.net|
name|whois.nic.name|No match|whois.nic.name|whois.nic.name|
pro|whois.internic.net|No match for|whois.internic.net|whois.internic.net|
ie|whois.domainregistry.ie|% There was no match in the IE Domain|whois.domainregistry.ie|whois.domainregistry.ie|
us|whois.nic.us|Not found:|whois.nic.us|whois.nic.us|
tk|whois.dot.tk|not known|whois.dot.tk|whois.dot.tk|
cd|whois.cd|No match|whois.cd|whois.cd|
aero|whois.information.aero|is available|whois.information.aero|whois.information.aero|
gr|whois.ripe.net|No entries found|whois.ripe.net|whois.ripe.net|
by|whois.ripe.net|No entries found|whois.ripe.net|whois.ripe.net|
ad|whois.ripe.net|No entries found|whois.ripe.net|whois.ripe.net|
lv|whois.ripe.net|No entries found|whois.ripe.net|whois.ripe.net|
bz|mhpwhois1.verisign-grs.net|No match|mhpwhois1.verisign-grs.net|
es|whois.ripe.net|no entries found|whois.ripe.net|whois.ripe.net|
jp|whois.nic.ad.jp|No match!!|whois.nic.ad.jp|whois.nic.ad.jp|
cl|whois.nic.cl|no existe|whois.nic.cl|whois.nic.cl|
ag|whois.nic.ag|does not exist|whois.nic.ag|whois.nic.ag|
